....................
....................
....................
....................
....................
....................
....................
...........CCC......
.........CC###......
......CCC...........
......###.......CCC.
................###.
.###................
............BB......
####################
